您	nín
老	lǎo
师	shī
家	jiā
同	tóng
学	xué
是	shì
生	shēng
也	yě
和	hé
她	tā
都	dōu
汉	hàn
语	yǔ
呢	ne
韩	hán
的	de
还	hái
日	rì
中	zhōng
国	guó
人	rén
七	qī
三	sān
两	liǎng
美	měi
四	sì
德	dé
九	jiǔ
英	yīng
