现	xiàn
在	zài
始	shǐ
先	xiān
复	fù
然	rán
后	hòu
再	zài
做	zuò
练	liàn
给	gěi
请	qǐng
些	xiē
别	bié
错	cuò
多	duō
音	yīn
对	duì
发	fā
笔	bǐ
少	shǎo
古	gǔ
叶	yè
外	wài
里	lǐ
田	tián
出	chū
由	yóu
甲	jiǎ
申	shēn
