这	zhè
字	zì
认	rèn
识	shì
怎	zěn
念	niàn
那	nà
词	cí
言	yán
左	zuǒ
边	biān
水	shuǐ
右	yòu
又	yòu
旁	páng
上	shàng
面	miàn
下	xià
口	kǒu
几	jǐ
画	huà
共	gòng
句	jù
子	zi
没	méi
看	kàn
懂	dǒng
话	huà
次	cì
要	yào
