哥	gē
妹	mèi
首	shǒu
访	fǎng
者	zhě
因	yīn
为	wèi
当	dāng
翻	fān
译	yì
所	suǒ
以	yǐ
爱	ài
女	nǚ
住	zhù
活	huó
已	yǐ
经	jīng
蓝	lán
眼	yǎn
睛	jīng
黄	huáng
黑	hēi
妇	fù
鼻	bí
比	bǐ
矮	ǎi
颜	yán
色	sè
将	jiāng
