上午 (shàngwǔ)	{am} Vormittag
刚 (gāng)	{gerade} eben; gerade erst; eben erst; erst vor Kurzem; kaum; gerade einmal (Anm.: In seiner zeitbezogenen Verwendung kennzeichnet 刚ein Ereignis oder einen Zustand als subjektiv erst kurz vor dem Bezugszeitpunkt eingetreten und ununterbrochen bis in diesen fortwirkend - z.B. wirkt 到in 她刚到 = „Sie ist gerade eben / erst vor Kurzem angekommen" insofern ununterbrochen bis zum Bezugszeitpunkt - hier: bis zum Zeitpunkt des Sprechens - fort, als „sie" die ganze Zeit bis zu diesem Zeitpunkt da ist.)
在 (zài)	beim ... sein; dabei sein zu ... (在 hier Adverb! Es drückt den progressiven Aspekt aus, d.h., dass man eine Tätigkeit als im Gange befindlich betrachtet; dient manchmal auch zur Intensivierung des Ausdrucks - Bsp.: 我在问你 ... = „Ich frage dich ..."; entspricht in vielen Fällen der englischen „‑ing"‑Form)
正在 (zhèngzài)	gerade beim ... sein; gerade dabei sein zu ... (kennzeichnet eine Tätigkeit als gerade zu einem Bezugszeitpunkt (z.B. dem Zeitpunkt des Sprechens) im Gange befindlich; meist nur mit „gerade" + Verb übersetzt)
看 (kàn)	(hier:) sich anschauen; auf ... schauen
... 的时候 (... deshíhòu)	(temporales) wenn ...; als ... (Beispiel: 他来的时候 = „wenn er kommt"/„als er kam", wörtlich „[zum] Zeitpunkt von ‚er kommt'")
时候 (shíhòu)	Zeitpunkt; Moment; Zeit
刚刚 (gānggāng)	{gerade} eben; gerade erst; eben erst; erst vor Kurzem; kaum; gerade einmal (wie 刚, betont aber stärker die subjektive Kürze des Zurückliegens)
从 (cóng)	(hier:) durch
大门口 (dàménkǒu)	Toreingang
门口 (ménkǒu)	Eingang
进来 (jìnlái)	hereinkommen
来 (lái)	(drückt als Richtungskomplement aus, dass sich eine Handlung „her" zur Position des Sprechers oder zu dem Ort, in den sich der Sprecher hineinversetzt, vollzieht)
来 (lái)	(Hauptbedeutung:) kommen
刚好 (gānghǎo)	zufällig gerade; es trifft/traf sich, dass; zufällig genau; gerade noch (wie in „gerade noch ... erreicht haben")
看见 (kànjiàn)	sehen; erblicken
见 (jiàn)	(Resultatkomplement, v.a. zum Ausdruck, dass eine der sensorischen Aktivitäten „schauen", „hinhören", „riechen" zur entsprechenden Sinnesempfindung geführt hat)
正 (zhèng)	(mit zeitlichem Bezug:) gerade (zu einem Bezugszeitpunkt, z.B. dem Zeitpunkt des Sprechens); (sonst oft:) genau
要 (yào)	(hier:) wollen
里面 (lǐmiàn)	in; innen; drinnen; innerhalb; (mit 的:) innere{r/‌‑s}
走过来 (zǒuguòlái)	sich (zu Fuß) nähern; (zu Fuß) herüberkommen
过来 (guòlái)	(Richtungskomplement zur Angabe, dass eine Handlung her zum Sprecher oder zu dem Ort, in den sich der Sprecher hineinversetzt, erfolgt; im Gegensatz zu 来, das als Verbkomplement nur die Richtung angibt, veranschaulicht 过来 jedoch den Vorgang; dieser kann, aber muss nicht - wie es das deutsche „herüber" ausdrückt - in einer Durch- oder Überquerung von etwas anderem als dem bloßen Raum bestehen.)
过来 (guòlái)	herkommen; herüberkommen (vgl. damit 来 = „kommen")
过 (guò)	passieren; überqueren; überschreiten; übertreffen (zeitliche Bedeutungen des Verbs 过in L. 12)
位 (wèi)	(höfliches Zähleinheitswort für Personen, darf aber nicht auf das Wort 人 angewendet werden)
啊 (a)	(hier zum Ausdruck einer leichten Überraschung; länger ausgesprochen zum Ausdruck des Begreifens; kürzer ausgesprochen zum Ausdruck des Einverständnisses)
刚才 (gāngcái)	soeben; gerade (im Sinn von „soeben"); eben (Anmerkung: im Unterschied zu 刚{刚} kennzeichnet 刚才 ein Geschehen als tatsächlich knapp - im Allgemeinen max. eine halbe Stunde - vor dem Zeitpunkt des Sprechens (nicht einem sonstigen Bezugszeitpunkt) eingetreten und drückt kein ununterbrochenes Fortwirken des Geschehens bis zum Bezugszeitpunkt aus; zudem ist 刚才 ein Zeitnomen und kann als solches verwendet werden.)
还 (hái)	(hier:) noch (im zeitlichen Sinn)
见 (jiàn)	sehen; sich mit ... treffen; einander sehen/treffen; besuchen
过 (guò)	(Aspektpartikel, die vor allem an Aktionsverben und an Adjektive, die einen Zustand und keine Eigenschaft bezeichnen, angehängt werden kann, um auszudrücken, dass etwas, was nicht mehr andauert, einmal der Fall war; meist verwendet, wenn es um die gemachte Erfahrung geht; Beispiel: 他去过那儿。= „Er war einmal dort." - und weiß daher z.B., wie man hinkommt)
这么说 (zhèmeshuō)	(hier:) demnach; (sonst auch:) es so sagen; das sagen
这么 (zhème)	so; auf diese Weise
国 (guó)	Land; Staat
有意思 (yǒuyìsī)	amüsant/spaßig/interessant sein; Sinn haben; sinnvoll sein; gedankentief sein
叫 (jiào)	(hier:) nennen
吧 (ba)	(Partikel zum Ausdruck einer Vermutung, einer Bitte, eines Vorschlags, einer milden Aufforderung (ohne 吧 strenger), eines verhandelnden Tonfalls (wie in 好吧 weiter unten im Lektionstext)
华 (huá)	China; chinesische{r/‌‑s} (nur in Zusammensetzungen)
华 (huá)	(ein Familienname)
声 (shēng)	Ton (in den Bezeichnungen für die chinesischen Silbentöne, z.B. 第一声 = erster Ton)
声调 (shēngdiào)	Silbenton (aber nicht in den Bezeichnungen für die chinesischen Silbentöne); Stimme
准 (zhǔn)	genau; exakt
常 (cháng)	oft; öfters
有时候 (yǒushíhòu)	manchmal (wörtl.: "es gibt Zeitpunkte")
小 (xiǎo)	(Präfix, in dieser Lektion vor dem Familiennamen einer jüngeren vertrauten Person)
小 (xiǎo)	klein (nicht, wenn nur auf die vertikale Dimension - z.B. die Körpergröße - bezogen); (bei Menschen:) jung
老 (lǎo)	(Präfix, in dieser Lektion vor dem Familiennamen einer älteren vertrauten bzw. Vertraulichkeit anbietenden Person)
老生 (lǎoshēng)	Höhersemestrige{r}; Schüler{in} einer höheren Klasse (auch: Bezeichnung für die ältere männliche Rolle in der Peking-Oper)
不能 (bùnéng)	(hier:) nicht dürfen; (sonst auch:) nicht können; nicht zu ... in der Lage sein; nicht zu ... vermögen
句 (jù)	Satz
句 (jù)	(Zähleinheitswort für kurze zusammenhängende Äußerungen mit vollständigem Sinn, v.a.:) Satz, Verszeile
下午 (xiàwǔ)	{am} Nachmittag
讲座 (jiǎngzuò)	Vortrag
咱们 (zánmen)	wir (nordchinesisch umgangssprachlich, wenn der/die Angesprochene{n} inkludiert ist/sind)
一起 (yīqǐ)	gemeinsam; zusammen
中午 (zhōngwǔ)	{zu} Mittag
点儿 (diǎner)	(hier:) Kurzform von 一点儿 (Achtung: das 有点儿 in 有点儿事 ist das Verb有 = „haben" + das Zähleinheitswort 点儿, nicht das Adverb 有点儿 = „etwas"/„ein wenig"aus L. 3; wenn 一点儿 Objektattribut wie in 有一点儿事oder Komplement wie in 慢一点儿 = „ein bisschen langsamer" ist, lässt man ein unbetontes „‍一‍" häufig wegfallen)
一点儿 (yīdiǎner)	ein bisschen; ein wenig (aber nicht zeitlich wie in „ein bisschen warten") (in {一}点儿事 im Lektionstext trägt {一}点儿 hauptsächlich zur Höflichkeit bei)
有事 (yǒushì)	etwas vorhaben; etwas zu tun haben (im Lektionstext: 有点儿事 = „etwas zu erledigen haben",
有事 (yǒushì)	umwunden ausgedrückt); ein Anliegen haben
事 (shì)	Angelegenheit; Sache (im Sinn von „Angelegenheit", nicht von „Ding"); Anliegen
等 (děng)	{auf...} warten
等 (děng)	(In 等一会儿去 im Lektionstext entspricht 等一会儿 - wörtl. „warten eine Weile" - annähernd dem deutschen „dann etwas später"; mit 等 wirkt die Wortgruppe höflicher.)
一会儿 (yīhuìer)	eine {kurze} Weile; ein Weilchen; ein Moment; kurz (zeitlich); ein bisschen {zeitlich} (in der letzten Zeile des Lektionstexts:) dann gleich; (sonst auch:) in/‌nach einer {kurzen} Weile; kurze Zeit später; gleich
就 (jiù)	(hier:) gleich
好 (hǎo)	(hier:) leicht zu
办公室 (bàngōngshì)	Büro, Sekretariat (办 = „erledigen", 公 = „öffentlich", hier „Öffentliches", 室 = „Raum")
慢 (màn)	langsam
记 (jì)	notieren; sich merken
一下{儿} (yīxià{er})	mal; mal kurz (in diesen Verwendungen drückt „一下{儿}" oft die Kürze oder den versuchsartigen bzw. saloppen Charakter einer Handlung aus, v.a. in Aufforderungssätzen auch Höflichkeit - man will das Gegenüber nicht überfordern und stellt deshalb die Handlung, die man sich von ihm erwünscht, als versuchsartig oder kurz dar); (weitere Bedeutung:) ein Mal (genaue Frequenzangabe bei gewissen kurzen Bewegungen wie z.B. „klopfen")
没关系 (méiguānxì)	macht nichts (abgekürzte Form von 没有关系 = „ohne Belang sein", wörtl. „keine Beziehung haben"; als Erwiderung auf 对不起 sagt man 没关系 ohne 有)
记上 (jìshàng)	notieren; aufschreiben
上 (shàng)	(als Richtungskomplement v.a. „auf"); (drückt als Resultatskomplement oft aus, dass die jeweilige Handlung einen anhaltenden Zustand nach sich zieht, der sich aus dem Aufeinandertreffen von Dingen ergibt - z.B. treffen in关上门 = „die Tür schließen" der Türflügel und der Türpfosten aufeinander; manchmal ist dieses Aufeinandertreffen recht abstrakt wie z.B. in 记上: das zu Notierende kommt mit dem Papier in Kontakt.)
行 (xíng)	o.k.; passt; es geht (行 ist tatsächlich das alte chinesische Wort für die Tätigkeit „gehen")
热心 (rèxīn)	bereitwillig; hilfsbereit; hingebungsvoll; leidenschaftlich
帮助 (bāngzhù)	helfen
帮助 (bāngzhù)	Hilfe
千万别 (qiānwànbié)	auf keinen Fall (in Aufforderungen)
千万 (qiānwàn)	auf jeden Fall; unter allen Umständen; unbedingt
回见 (huíjiàn)	bis später; bis bald
